 ###########
 #.......  #
 #         #
##*******  #
#          #
# $$$$$$$@ #
#   # # # ##
# # #     # 
#   ####### 
#####       
