############
#          #
# $.  $    #
#        . #
#   @  $   #
##         #
#          #
# .        #
#         ##
#          #
#       #  #
############
