############
#   #      #
# .   .  $ #
#          #
# . @      #
#         ##
#         ##
# $ $      #
#          #
#          #
#   #   #  #
############
