############
#      #   #
# .        #
# $        #
#   @      #
#        . #
#          #
# $ .  $  ##
#          #
#          #
#    #     #
############
