########
# #@.  #
#.  $  #
##.    #
#      #
#  $ $ #
#      #
########
