########
#. @#.##
# ###$ #
#.$ #  #
#  $   #
#   #  #
#      #
########
0.7090909090909091
