########
# @ ...#
#    # #
# ## $ #
#  # # #
#  $ $ #
#     ##
########
0.6862838915470495
