########
#@#    #
#    . #
# ## $ #
#      #
# # #  #
#     ##
########
0.7136363636363636
